#######
#.@   #
# $   #
#     #
#   $.#
#######