#####
#@  #
#   #
#$  #
#.  #
#####