#####
#@  #
#   #
# $ #
#.  #
#####