#####
#@  #
#.  #
# $ #
#   #
#####